Ww          , Ww          , Ww          , Ww          , Ww          , Ww          , Ww          , Ww          , Ww          , Ww          , Ww          , Ww          , Ww          , Ww          , Ww          , Ww          , Ds          , Ds          , Ds          , Gg          , Gg          , Gg          , Gg          , Gg          , Hh          , Hh          , Gg          , Gg          , Gg          , Gg          , Gg          , Ss          , Ww          , Wwf         , Ww          , Ww          , Ww          , Ww          
Ww          , Ww          , Ww          , Ds          , Ww          , Ds          , Ds          , Ds          , Ww          , Ds          , Ww          , Ds          , Ww          , Ww          , Ww          , Ds          , Ww          , Ww          , Wwf         , Wwf         , Gg          , Gg          , Gg          , Ds          , Hh          , Hh          , Hh          , Hh          , Gg          , Gg          , Gg          , Ss          , Ss          , Ss          , Wwf         , Wwf         , Ww          , Ww          
Ww          , Ds          , Ds          , 1 Ke        , Ds          , Rd          , Rd          , Rd          , Ds          , Re          , Ds          , Rd          , Ds          , Ds          , Ds          , Gg          , Ds          , Ds          , Ww          , Ww          , Wwf         , Ds          , Ds          , Gs^Fp       , Hh          , Hh          , Mm          , Mm          , Hh          , Gg          , Ss          , Ss          , Ss          , Ss          , Ss          , Ss          , Wwf         , Wwf         
Ds          , Re^Uf       , Ce          , Ce          , Ce          , Re          , Re^Uf       , Rd          , Rd          , Rd          , Re          , Re          , Rd          , Rd          , Gg          , Gg          , Gg          , Gg^Vh       , Ds          , Ds          , Ww          , Ww          , Ds          , Hh          , Hh          , Mm          , Hh^Vhh      , Mm          , Mm          , Mm          , Hh          , Gg          , Ss^Vhs      , Ss          , Ss          , Ss          , Ss          , Ss          
Re^Uf       , Re          , Ce          , Ce          , Ce          , Re          , Gg^Vh       , Rd          , Rd          , Rd          , Re^Uf       , Gg          , Re          , Re          , Gg          , Gg          , Gg          , Gg          , Gg          , Gg          , Ds          , Ww          , Hh          , Hh          , Mm          , Hh          , Mm          , Mm          , Mm          , Hh          , Hh          , Hh          , Gg          , Ss          , Ss          , Ss          , Ss          , Ss          
Rd          , Re          , Re          , Rd          , Rd          , Re          , Rd          , Gg          , Rd          , Gg          , Gg          , Gg          , Rd          , Re          , Gg          , Gg          , Gg          , Gg          , Gg          , Gg          , Gg          , Ww          , Ds          , Wwf         , Wwf         , Wwf         , Hh          , Gg^Ve       , Hh          , Mm          , Mm          , Hh          , Gg          , Ss          , Ss          , Ss          , Ss          , Ss          
Rd          , Gg^Ve       , Rd          , Re          , Re          , Gg          , Gg          , Gg^Ve       , Gg          , Gg          , Gg          , Gs          , Rd          , Re          , Gg          , Re          , Gg          , Gg          , Gg          , Gg          , Gg          , Gg          , Ww          , Ww          , Ww          , Ww^Bw/      , Ww^Bw/      , Mm          , Mm          , Mm^Vhh      , Mm          , Mm          , Hh          , Gg          , Ss          , Ss          , Ss          , Ss          
Rd          , Re          , Re          , Re          , Re          , Gg          , Gs          , Gg          , Gs          , Gg          , Gg          , Gs          , Gs          , Gs          , Re          , Rd          , Re          , Re          , Re          , Re          , Gg          , Gs^Vht      , Ww          , Ww^Bw/      , Ww^Bw/      , Ww          , Wwf         , Mm          , Mm          , Mm          , Hh          , Hh          , Hh          , Gg          , Ss          , Ss          , Ss          , Ss          
Re          , Re          , Re          , Gg          , Rr          , Gg          , Gg          , Gg          , Gg          , Gg          , Gg          , Gg          , Gg          , Gg          , Gg          , Gg          , Gg          , Gg          , Gg          , Gg          , Re          , Re          , Ww^Bw/      , Ww          , Ww          , Hh          , Hh          , Hh          , Gs^Fp       , Gg          , Hh          , Gg          , Gg          , Gg          , Ss          , Ss          , Ss          , Ss          
Re          , Gg          , Rr          , Gg          , Gg          , Gg          , Gg          , Gg          , Gg          , Gg          , Gs          , Gg          , Gg          , Gg^Vh       , Gs          , Gg          , Gs          , Gs          , Gs          , Gg          , Gg          , Gg          , Hh          , Wwf         , Wwf         , Hh          , Hh          , Gg          , Gg          , Gg          , Gg          , Gg          , Gg          , Gg          , Gg          , Gg          , Ss^Vm       , Gg          
Re          , Gg          , Gg^Vh       , Gg          , Gg          , Gg          , Gg          , Gg          , Gg          , Gg          , Gs          , Gg          , Gs          , Gg          , Gg          , Gg          , Gs          , Gs          , Gs          , Gs          , Gs          , Gg          , Gg          , Hh          , Ww          , Hh          , Gg          , Gg          , Gg          , Gg          , Gg          , Gg          , Gg          , Gg          , Gg          , Gg          , Gg          , Gg          
Gg          , Gg          , Gg          , Ss          , Gg          , Gs^Fp       , Ss          , Gg          , Ss          , Gg          , Gg          , Gg          , Gg          , Gg          , Gg          , Gg          , Gs          , Gs          , Gs          , Gs          , Gg          , Gg          , Gg          , Wwf         , Ww          , Gg^Ve       , Gg          , Gg          , Gg          , Gg          , Gg          , Gg^Ve       , Gg          , Gg          , Gg          , Gg          , Gg          , Gg          
Gg          , Ss          , Ss          , Gg          , Gg          , Gg          , Ss          , Gg          , Ss          , Gs^Fp       , Gg          , Gg          , Gg          , Gg          , Gg          , Gg          , Gs          , Gs          , Gs          , Gs          , Gg          , Gg          , Gg          , Gg          , Wwf         , Ss          , Gg          , Gg          , Gg          , Gg          , Gg          , Gg          , Gg          , Gg          , Gg          , Gg          , Gg          , Gg          
Gg          , Ss          , Ss          , Gg          , Ss          , Ss^Bw|      , Ss          , Gg          , Ss          , Ss^Vhs      , Gg          , Gg          , Gg          , Ss          , Gg          , Gg          , Gg          , Gg          , Gg          , Gg          , Gg          , Gg          , Gg          , Gg          , Ww          , Ss          , Gg          , Gg^Fet      , Gg          , Gg          , Gg          , Gg          , Gg          , Gg          , Gg          , Gg          , Aa          , Hh          
Gs^Fp       , Gs^Fp       , Gs^Fp       , Ss          , Ss          , Ss^Bw|      , Ss          , Ss          , Ss          , Ss          , Gg          , Ss          , Ss          , Gg          , Gg          , Gg          , Gg          , Gg          , Gg          , Gg          , Gg          , Hh          , Gg          , Gg          , Ss          , Ss          , Gg          , Gg          , Gg          , Gg          , Gg          , Gg          , Gg          , Hh          , Gg          , Aa          , Ha          , Ha          
Ss          , Ss          , Ss          , Ss^Vm       , Ss          , Ss^Bw|      , Gs^Fp       , Ss          , Ss          , Gs^Fp       , Ss          , Ss          , Gs^Fp       , Gg          , Gg          , Gg          , Gs^Fp       , Gg          , Gg          , Gs^Fp       , Gg          , Gs^Fp       , Gg          , Gg          , Gs^Fp       , Ss          , Gg          , Gg          , Gg          , Gg          , Gg          , Aa          , Aa          , Aa^Fpa      , Aa          , Ha          , Ha          , Aa          
Ss          , Ss          , Ss          , Ss          , Ss          , Ss^Bw|      , Ss          , Ss          , Gs^Fp       , Ss          , Ss          , Hh          , Gg          , Gg          , Gg^Vh       , Gg          , Gg          , Gg          , Gs^Fp       , Hh          , Gg          , Gg          , Gg          , Gg          , Ss          , Hh          , Gg          , Gg          , Gg          , Gg          , Aa^Vha      , Ha          , Hh          , Ha          , Ha          , Hh          , Aa          , Aa          
Ss          , Ss          , Gg^Fet      , Ss          , Ss          , Ss^Bw|      , Ss          , Ss          , Ss          , Ss          , Gs^Fp       , Ss          , Ss          , Ss          , Ss          , Gg          , Gg          , Gs^Fp       , Gg          , Gs^Fp       , Gg          , Gs^Fp       , Gg          , Gg          , Ss          , Ss          , Gs^Fp       , Gg          , Gg          , Aa^Fpa      , Hh          , Aa^Fpa      , Ha          , Aa          , Ha          , Aa          , Aa          , Aa          
Ss          , Ss          , Ss          , Gs^Fp       , Ss          , Ss^Vhs      , Chs         , Ss          , Ss          , Ss          , Ss          , Ss          , Ss          , Gg          , Gg          , Gs^Fp       , Gg          , Hh          , Gg          , Gg          , Gg          , Gg^Ve       , Gg          , Gs^Fp       , Ss          , Gs^Fp       , Ss          , Gg          , Gg          , Hh          , Ha          , Hh          , Ha          , Aa          , Hh          , Ha          , Aa          , Ha          
Ss          , Gs^Fp       , Ss          , Ss          , Ss          , Ss          , 2 Khs       , Ss          , Ss          , Gs^Fp       , Ss          , Ss          , Gs^Fp       , Gg          , Gg          , Gg          , Gg          , Mm          , Gg          , Hh          , Gs^Fp       , Hh          , Gg          , Gg          , Ss          , Ss          , Ss          , Ss          , Gg          , Hh          , Aa^Fpa      , Aa          , Aa          , Ha          , Ha          , Aa^Fpa      , Ha          , Aa^Fpa      
Ss          , Ss          , Ss          , Ss          , Ss          , Ss          , Chs         , Ss          , Gg          , Ss          , Ss          , Ss          , Gg          , Ss          , Ss          , Gg          , Hh          , Gs^Fp       , Mm          , Hh          , Gs^Fp       , Gg          , Gg          , Ss          , Ss          , Gs^Fp       , Ss          , Hh          , Ha          , Hh          , Ha          , Aa          , Aa          , Aa^Fpa      , Aa          , Aa^Fpa      , Aa^Fpa      , Aa^Fpa      
