Cud         , 2 Kud       , Xu          , Xu          , Xu          , Xu          , Xu          , Xu          , Ww          , Wwf         , Ww          , Ww          , Xu          , Xu          , Xu          , Xu          , Xu          , Xu          , Xu          , Xu          
Cud         , Cud         , Cud         , Xu          , Xu          , Uu^Vud      , Xu          , Xu          , Wwf         , Rd          , Wwf         , Xu          , Xu          , Xu          , Xu          , 3 Kud       , Xu          , Xu          , Xu          , Xu          
Uh          , Uu          , Uu          , Xu          , Xu          , Uu          , Xu          , Xu          , Xu          , Uu^Ii       , Xu          , Xu          , Xu          , Xu          , Cud         , Cud         , Cud         , Uu^Uf       , Xu          , Xu          
Uu          , Xu          , Uh          , Uh          , Uu^Uf       , Uh          , Xu          , Xu          , Xu          , Uh^Ii       , Xu          , Xu          , Xu          , Uh^Ii       , Uu          , Uu          , Uu          , Uu          , Xu          , Xu          
Uh          , Xu          , Xu          , Xu          , Uu^Vu       , Uh          , Xu          , Uu          , Uu^Uf       , Xu          , Xu          , Xu          , Uu^Vu       , Uu          , Uu^Ii       , Xu          , Uu          , Uu          , Xu          , Xu          
Uh          , Uu^Vu       , Xu          , Xu          , Xu          , Xu          , Uu          , Xu          , Uh          , Uu^Vud      , Xu          , Xu          , Uu          , Uh          , Xu          , Uh^Ii       , Xu          , Uu          , Uu^Vu       , Xu          
Uu          , Uu          , Xu          , Uu          , Uh          , Uu^Vu       , Xu          , Xu          , Xu          , Uu          , Qxu         , Uu          , Uu          , Xu          , Xu          , Uu^Ii       , Uu^Ii       , Uu          , Uu          , Xu          
Uu^Uf       , Xu          , Xu          , Uu          , Xu          , Uu^Uf       , Xu          , Xu          , Xu          , Xu          , Uu          , Xu          , Xu          , Uh^Ii       , Uu^Ii       , Xu          , Xu          , Uu          , Uh          , Uu          
Uh^Ii       , Xu          , Xu          , Uu          , Uu          , Xu          , Xu          , Xu          , Xu          , Xu          , Uu^Uf       , Xu          , Xu          , Xu          , Uh^Ii       , Uu^Ii       , Xu          , Xu          , Uu^Uf       , Uh          
Uu^Uf       , Uu          , Uu^Vud      , Uh          , Xu          , Xu          , Uu^Vud      , Uh          , Xu          , Uu^Vud      , Uu          , Xu          , Uh          , Uu          , Xu          , Xu          , Uu^Ii       , Uh          , Xu          , Uu^Vud      
Xu          , Uu          , Uu          , Uu          , Xu          , Uu          , Uu          , Uu          , Xu          , Xu          , Xu          , Uu^Vu       , Uu          , Xu          , Uh          , Uu          , Uu          , Uu          , Xu          , Xu          
Uu          , Uu^Vu       , Xu          , Xu          , Uu          , Uu^Uf       , Xu          , Uu          , Uu^Uf       , Uu          , Uu          , Uh          , Xu          , Uu^Vud      , Xu          , Uu          , Xu          , Xu          , Uu^Vu       , Xu          
Xu          , Xu          , Xu          , Uu^Vud      , Qxu         , Uh          , Xu          , Xu          , Uh          , 6 Kud       , Uu^Uf       , Xu          , Xu          , Uh          , Xu          , Uh          , Xu          , Xu          , Xu          , Xu          
Xu          , Xu          , Xu          , Uu^Ii       , Qxu         , Qxu         , Xu          , Xu          , Cud         , Cud         , Cud         , Xu          , Xu          , Uu^Uf       , Xu          , Uu^Uf       , Xu          , Qxu         , Uu^Vu       , Uu          
Xu          , Uu          , Uu          , Uu^Ii       , Uh^Ii       , Uh          , Xu          , Xu          , Cud         , Uu          , Cud         , Xu          , Xu          , Uu^Vu       , Xu          , Uu          , Qxu         , Qxu         , Xu          , Uh          
Uu^Uf       , Xu          , Xu          , Uu          , Uu^Uf       , Uu          , Xu          , Xu          , Uu          , Uh          , Uu          , Xu          , Xu          , Uu          , Xu          , Uu^Uf       , Qxu         , Uh^Ii       , Xu          , Uu          
Uh          , Xu          , Uu^Vu       , Xu          , Xu          , Uu^Uf       , Uu          , Uu^Vud      , Uu          , Xu          , Uu          , Uu          , Xu          , Uu          , Xu          , Xu          , Uh          , Xu          , Xu          , Uu^Vud      
Uh^Ii       , Xu          , Xu          , Xu          , Xu          , Uu^Uf       , Xu          , Xu          , Uu          , Uu          , Xu          , Xu          , Uu          , Xu          , Uu^Uf       , Xu          , Xu          , Xu          , Xu          , Uu          
Uu^Ii       , Uu^Vud      , Uu^Uf       , Xu          , Xu          , Uu          , Uu          , Xu          , Xu          , Uu^Ii       , Xu          , Xu          , Uu          , Xu          , Xu          , Uu^Uf       , Uu^Vud      , Uu          , Xu          , Uu          
Xu          , Xu          , Uu          , Uu          , Uu^Uf       , Uu          , Uu^Vu       , Uh          , Qxu         , Uu^Uf       , Uh^Ii       , Xu          , Uu          , Uu          , Xu          , Uu          , Uh          , Xu          , Uh^Ii       , Xu          
Xu          , Uu          , Uu          , Xu          , Xu          , Xu          , Uh          , Uh          , Uu          , Uu          , Uu          , Xu          , Uh^Ii       , Uh          , Uu          , Uu^Uf       , Xu          , Uh          , Uu          , Xu          
Xu          , Uu^Ii       , Xu          , Uu          , Uu          , Uu          , Xu          , Xu          , Uu          , Uu^Vu       , Uh          , Xu          , Uu^Vu       , Xu          , Xu          , Xu          , Xu          , Xu          , Uu          , Xu          
Uu^Ii       , Uh^Ii       , Xu          , Uu          , Xu          , Uu          , Uh          , Xu          , Uu^Uf       , Qxu         , Qxu         , Uh          , Xu          , Uu          , Uu          , Uu^Uf       , Xu          , Uh          , Uu^Ii       , Uu^Uf       
Uu          , Xu          , Xu          , Uu          , Xu          , Uu          , Uu^Uf       , Xu          , Qxu         , Uu^Vud      , Xu          , Uu          , Uu          , Xu          , Uh          , Xu          , Uu          , Uu          , Uu          , Cud         
Uu          , Xu          , Uu^Vud      , Uu          , Xu          , Uu^Vu       , Uu          , Qxu         , Qxu         , Qxu         , Uu^Uf       , Xu          , Uu          , Uu          , Uu          , Xu          , Uu^Vu       , Uh          , Cud         , 4 Kud       
Uh          , Xu          , Uu          , Xu          , Xu          , Xu          , Uu          , Uu          , Qxu         , Xu          , Xu          , Uu^Vud      , Xu          , Uu          , Uh^Ii       , Xu          , Uu^Uf       , Xu          , Cud         , Cud         
Uu^Uf       , Xu          , Uh          , Uu          , Xu          , Uu^Vud      , Xu          , Uu^Uf       , Uu          , Uu          , Uu          , Uh          , Xu          , Xu          , Uu          , Uu          , Xu          , Uh          , Xu          , Xu          
Uh          , Uu          , Xu          , Xu          , Uu^Uf       , Uh          , Xu          , Uh          , Uu          , 1 Kud       , Uu          , Uu          , Uh          , Uh          , Xu          , Uu^Uf       , Uu          , Qxu         , Uu^Vu       , Xu          
Cud         , Cud         , Uu          , Uu          , Xu          , Uu          , Xu          , Xu          , Cud         , Cud         , Cud         , Xu          , Uu          , Uu          , Xu          , Xu          , Uu          , Uu          , Xu          , Uu^Vud      
5 Kud       , Cud         , Xu          , Uu^Vud      , Uh          , Uu^Uf       , Xu          , Rd          , Rd          , Re          , Rd          , Rd          , Xu          , Xu          , Uu^Ii       , Uu          , Uu^Uf       , Qxu         , Uu^Ii       , Uh          
